Experiment Number,Map Seed,Number of Agents,Agents Seed,Uncertainty,Timeout,initial time,octu Time,initial Min Cost,initial Max Cost,initial uncertainty,initial true cost,octu Min Cost,octu Max Cost,octu uncertainty,final true cost,Sensing Probability,Distribution,Communication
1,96372106,3,10637296,1,60,0.004984378814697266,0.013962507247924805,24,37,13,37,37,37,0,37,0.75,max,True
2,96372106,3,10637297,1,60,0.0010001659393310547,0.003989219665527344,16,19,3,19,18,19,1,19,0.75,max,True
3,96372106,3,10637298,1,60,0.006952762603759766,0.011968135833740234,26,32,6,32,31,32,1,32,0.75,max,True
4,96372106,3,10637299,1,60,0.01296544075012207,0.01196908950805664,23,35,12,35,31,33,2,33,0.75,max,True
5,96372106,3,10637300,1,60,0.0049974918365478516,0.013962030410766602,23,31,8,31,29,30,1,30,0.75,max,True
6,96372106,3,10637301,1,60,0.005972862243652344,0.01097559928894043,24,38,14,38,37,38,1,38,0.75,max,True
7,96372106,3,10637302,1,60,0.05088162422180176,0.028890371322631836,25,37,12,37,38,38,0,38,0.75,max,True
8,96372106,3,10637303,1,60,0.000993967056274414,0.0029914379119873047,14,20,6,20,19,20,1,20,0.75,max,True
9,96372106,3,10637304,1,60,0.01599407196044922,0.005984306335449219,19,28,9,28,28,28,0,28,0.75,max,True
10,96372106,3,10637305,1,60,0.008973360061645508,0.014960765838623047,22,29,7,29,29,29,0,29,0.75,max,True
11,96372106,3,10637306,1,60,0.0,0.002990245819091797,9,18,9,18,18,18,0,18,0.75,max,True
12,96372106,3,10637307,1,60,0.003989219665527344,0.006981849670410156,21,30,9,30,32,33,1,33,0.75,max,True
13,96372106,3,10637308,1,60,0.005013227462768555,0.007978439331054688,20,29,9,29,28,29,1,29,0.75,max,True
14,96372106,3,10637309,1,60,0.024969100952148438,0.010972261428833008,19,28,9,28,31,31,0,31,0.75,max,True
15,96372106,3,10637310,1,60,0.006981611251831055,0.011967897415161133,24,37,13,37,37,37,0,37,0.75,max,True
16,96372106,3,10637311,1,60,0.0009996891021728516,0.003989219665527344,18,23,5,23,23,23,0,23,0.75,max,True
17,96372106,3,10637312,1,60,0.0009965896606445312,0.003989219665527344,16,21,5,21,21,21,0,21,0.75,max,True
18,96372106,3,10637313,1,60,0.00498652458190918,0.007978200912475586,25,35,10,35,35,35,0,35,0.75,max,True
19,96372106,3,10637314,1,60,0.046840667724609375,0.00498652458190918,22,29,7,29,28,28,0,28,0.75,max,True
20,96372106,3,10637315,1,60,0.0039861202239990234,0.003988981246948242,15,21,6,21,21,22,1,22,0.75,max,True
21,96372106,3,10637316,1,60,0.0050220489501953125,0.005983829498291016,21,33,12,33,35,36,1,36,0.75,max,True
22,96372106,3,10637317,1,60,0.005980014801025391,0.01296687126159668,22,31,9,31,31,31,0,31,0.75,max,True
23,96372106,3,10637318,1,60,0.0009908676147460938,0.003989219665527344,15,22,7,22,22,22,0,22,0.75,max,True
24,96372106,3,10637319,1,60,0.0009696483612060547,0.00498652458190918,19,27,8,27,26,27,1,27,0.75,max,True
25,96372106,3,10637320,1,60,0.0,0.002991914749145508,12,16,4,16,16,16,0,16,0.75,max,True
26,96372106,3,10637321,1,60,0.0009965896606445312,0.0019941329956054688,17,21,4,21,21,21,0,21,0.75,max,True
27,96372106,3,10637322,1,60,0.001982450485229492,0.0019943714141845703,14,19,5,19,19,19,0,19,0.75,max,True
28,96372106,3,10637323,1,60,0.0009980201721191406,0.007978677749633789,21,28,7,28,28,28,0,28,0.75,max,True
29,96372106,3,10637324,1,60,0.00102996826171875,0.003988981246948242,13,16,3,16,14,16,2,16,0.75,max,True
30,96372106,3,10637325,1,60,0.004987001419067383,0.008976221084594727,14,21,7,21,21,21,0,21,0.75,max,True
31,96372106,3,10637326,1,60,0.0658729076385498,0.009971141815185547,23,33,10,33,31,32,1,32,0.75,max,True
32,96372106,3,10637327,1,60,0.006981372833251953,0.014960527420043945,18,27,9,27,25,26,1,26,0.75,max,True
33,96372106,3,10637328,1,60,0.003001689910888672,0.0069811344146728516,20,27,7,27,27,27,0,27,0.75,max,True
34,96372106,3,10637329,1,60,0.001994609832763672,0.010970115661621094,17,27,10,27,26,27,1,27,0.75,max,True
35,96372106,3,10637330,1,60,0.0,0.001994609832763672,10,11,1,11,11,11,0,11,0.75,max,True
36,96372106,3,10637331,1,60,0.0010306835174560547,0.003989219665527344,18,26,8,26,25,26,1,26,0.75,max,True
37,96372106,3,10637332,1,60,0.0009636878967285156,0.0029921531677246094,12,16,4,16,16,16,0,16,0.75,max,True
38,96372106,3,10637333,1,60,0.004986763000488281,0.0109710693359375,18,25,7,25,25,25,0,25,0.75,max,True
39,96372106,3,10637334,1,60,0.001005411148071289,0.003989458084106445,16,25,9,25,25,25,0,25,0.75,max,True
40,96372106,3,10637335,1,60,0.0009818077087402344,0.0009970664978027344,5,7,2,7,7,7,0,7,0.75,max,True
41,96372106,3,10637336,1,60,0.021914005279541016,0.015957117080688477,24,32,8,32,32,32,0,32,0.75,max,True
42,96372106,3,10637337,1,60,0.0040247440338134766,0.004986286163330078,19,29,10,29,29,29,0,29,0.75,max,True
43,96372106,3,10637338,1,60,0.023922443389892578,0.009973287582397461,26,39,13,39,38,38,0,38,0.75,max,True
44,96372106,3,10637339,1,60,0.02393627166748047,0.02293872833251953,18,26,8,26,24,24,0,24,0.75,max,True
45,96372106,3,10637340,1,60,0.0009984970092773438,0.003989696502685547,16,24,8,24,23,24,1,24,0.75,max,True
46,96372106,3,10637341,1,60,0.000995635986328125,0.0029916763305664062,15,24,9,24,24,24,0,24,0.75,max,True
47,96372106,3,10637342,1,60,0.003993988037109375,0.011968374252319336,18,20,2,20,20,20,0,20,0.75,max,True
48,96372106,3,10637343,1,60,0.0009942054748535156,0.005983829498291016,14,20,6,20,20,20,0,20,0.75,max,True
49,96372106,3,10637344,1,60,0.002998828887939453,0.00698089599609375,15,23,8,23,23,23,0,23,0.75,max,True
50,96372106,3,10637345,1,60,0.004017829895019531,0.006981611251831055,26,38,12,38,37,38,1,38,0.75,max,True
