Experiment Number,Map Seed,Number of Agents,Agents Seed,Uncertainty,Timeout,initial time,octu Time,initial Min Cost,initial Max Cost,initial uncertainty,initial true cost,octu Min Cost,octu Max Cost,octu uncertainty,final true cost,Sensing Probability,Distribution,Objective,Communication,Min SIC,Max SIC
1,96372106,5,10637296,1,60,0.0043599605560302734,0.0012593269348144531,35,49,14,40,35,49,14,40,0.0,uniform,Min Worst Case,True,34,52
2,96372106,5,10637297,1,60,0.001329660415649414,0.0008463859558105469,25,31,6,29,25,31,6,29,0.0,uniform,Min Worst Case,True,25,31
3,96372106,5,10637298,1,60,0.00683140754699707,0.0012350082397460938,38,43,5,42,38,43,5,42,0.0,uniform,Min Worst Case,True,36,47
4,96372106,5,10637299,1,60,0.05537605285644531,0.001470327377319336,39,47,8,42,39,47,8,42,0.0,uniform,Min Worst Case,True,32,54
5,96372106,5,10637300,1,60,0.1134026050567627,0.0013818740844726562,46,53,7,48,46,53,7,48,0.0,uniform,Min Worst Case,True,39,52
6,96372106,5,10637301,1,60,0.0059926509857177734,0.0014941692352294922,30,44,14,37,30,44,14,37,0.0,uniform,Min Worst Case,True,29,45
7,96372106,5,10637302,1,60,0.015590906143188477,0.0014612674713134766,48,67,19,56,48,67,19,56,0.0,uniform,Min Worst Case,True,45,72
8,96372106,5,10637303,1,60,0.00142669677734375,0.0008757114410400391,28,39,11,29,28,39,11,29,0.0,uniform,Min Worst Case,True,28,39
9,96372106,5,10637304,1,60,0.006725788116455078,0.0010404586791992188,28,38,10,32,28,38,10,32,0.0,uniform,Min Worst Case,True,26,41
10,96372106,5,10637305,1,60,0.08912920951843262,0.0010640621185302734,35,44,9,39,35,44,9,39,0.0,uniform,Min Worst Case,True,32,43
11,96372106,5,10637306,1,60,0.004935264587402344,0.0016148090362548828,32,49,17,45,32,49,17,45,0.0,uniform,Min Worst Case,True,31,52
12,96372106,5,10637307,1,60,0.026391983032226562,0.001302480697631836,34,48,14,42,34,48,14,42,0.0,uniform,Min Worst Case,True,33,52
13,96372106,5,10637308,1,60,0.013411521911621094,0.0011870861053466797,35,46,11,42,35,46,11,42,0.0,uniform,Min Worst Case,True,32,46
14,96372106,5,10637309,1,60,0.010153532028198242,0.0012104511260986328,30,44,14,35,30,44,14,35,0.0,uniform,Min Worst Case,True,29,48
15,96372106,5,10637310,1,60,0.11658239364624023,0.0015594959259033203,42,55,13,49,42,55,13,49,0.0,uniform,Min Worst Case,True,40,61
16,96372106,5,10637311,1,60,0.0015869140625,0.0009982585906982422,31,42,11,37,31,42,11,37,0.0,uniform,Min Worst Case,True,31,42
17,96372106,5,10637312,1,60,0.010726451873779297,0.0010619163513183594,27,34,7,31,27,34,7,31,0.0,uniform,Min Worst Case,True,25,32
18,96372106,5,10637313,1,60,0.021774768829345703,0.00128173828125,37,47,10,40,37,47,10,40,0.0,uniform,Min Worst Case,True,35,52
19,96372106,5,10637314,1,60,0.03613424301147461,0.0023124217987060547,36,44,8,40,36,44,8,40,0.0,uniform,Min Worst Case,True,29,50
20,96372106,5,10637315,1,60,0.002913236618041992,0.0027391910552978516,36,53,17,44,36,53,17,44,0.0,uniform,Min Worst Case,True,36,56
21,96372106,5,10637316,1,60,0.03697562217712402,0.0026547908782958984,43,63,20,55,43,63,20,55,0.0,uniform,Min Worst Case,True,39,67
22,96372106,5,10637317,1,60,0.0043697357177734375,0.0022993087768554688,30,39,9,36,30,39,9,36,0.0,uniform,Min Worst Case,True,29,40
23,96372106,5,10637318,1,60,0.0034935474395751953,0.002292156219482422,26,34,8,31,26,34,8,31,0.0,uniform,Min Worst Case,True,25,36
24,96372106,5,10637319,1,60,0.026293039321899414,0.0026204586029052734,40,52,12,48,40,52,12,48,0.0,uniform,Min Worst Case,True,37,58
25,96372106,5,10637320,1,60,0.00506281852722168,0.0019788742065429688,26,34,8,29,26,34,8,29,0.0,uniform,Min Worst Case,True,25,34
26,96372106,5,10637321,1,60,0.0012829303741455078,0.001773834228515625,25,33,8,27,25,33,8,27,0.0,uniform,Min Worst Case,True,25,33
27,96372106,5,10637322,1,60,0.037215232849121094,0.0012710094451904297,30,38,8,33,30,38,8,33,0.0,uniform,Min Worst Case,True,26,37
28,96372106,5,10637323,1,60,0.005142927169799805,0.0017514228820800781,33,44,11,38,33,44,11,38,0.0,uniform,Min Worst Case,True,33,45
29,96372106,5,10637324,1,60,0.0014252662658691406,0.0009918212890625,27,36,9,33,27,36,9,33,0.0,uniform,Min Worst Case,True,27,36
30,96372106,5,10637325,1,60,0.004384756088256836,0.001066446304321289,24,36,12,31,24,36,12,31,0.0,uniform,Min Worst Case,True,23,39
31,96372106,5,10637326,1,60,0.0369720458984375,0.0013663768768310547,38,49,11,46,38,49,11,46,0.0,uniform,Min Worst Case,True,34,48
32,96372106,5,10637327,1,60,0.028668880462646484,0.0013380050659179688,35,47,12,40,35,47,12,40,0.0,uniform,Min Worst Case,True,30,48
33,96372106,5,10637328,1,60,0.009000539779663086,0.0010869503021240234,39,52,13,45,39,52,13,45,0.0,uniform,Min Worst Case,True,38,58
34,96372106,5,10637329,1,60,0.04586195945739746,0.001466512680053711,35,46,11,41,35,46,11,41,0.0,uniform,Min Worst Case,True,32,50
35,96372106,5,10637330,1,60,0.0015254020690917969,0.0009815692901611328,24,32,8,28,24,32,8,28,0.0,uniform,Min Worst Case,True,24,32
36,96372106,5,10637331,1,60,0.012599468231201172,0.0010523796081542969,24,33,9,28,24,33,9,28,0.0,uniform,Min Worst Case,True,22,33
37,96372106,5,10637332,1,60,0.006180286407470703,0.0010061264038085938,27,39,12,32,27,39,12,32,0.0,uniform,Min Worst Case,True,25,36
38,96372106,5,10637333,1,60,0.04297232627868652,0.0010478496551513672,34,43,9,38,34,43,9,38,0.0,uniform,Min Worst Case,True,30,47
39,96372106,5,10637334,1,60,0.0034248828887939453,0.0009312629699707031,31,45,14,39,31,45,14,39,0.0,uniform,Min Worst Case,True,28,47
40,96372106,5,10637335,1,60,0.0008091926574707031,0.0006625652313232422,14,16,2,15,14,16,2,15,0.0,uniform,Min Worst Case,True,14,16
41,96372106,5,10637336,1,60,0.019197463989257812,0.0015270709991455078,45,57,12,52,45,57,12,52,0.0,uniform,Min Worst Case,True,43,68
42,96372106,5,10637337,1,60,0.004876375198364258,0.0009391307830810547,28,39,11,30,28,39,11,30,0.0,uniform,Min Worst Case,True,27,41
43,96372106,5,10637338,1,60,0.012291908264160156,0.0013713836669921875,34,48,14,39,34,48,14,39,0.0,uniform,Min Worst Case,True,33,53
44,96372106,5,10637339,1,60,0.05259346961975098,0.0011768341064453125,33,41,8,38,33,41,8,38,0.0,uniform,Min Worst Case,True,28,43
45,96372106,5,10637340,1,60,0.0027360916137695312,0.001310110092163086,29,41,12,34,29,41,12,34,0.0,uniform,Min Worst Case,True,28,41
46,96372106,5,10637341,1,60,0.0014624595642089844,0.0009610652923583984,24,34,10,30,24,34,10,30,0.0,uniform,Min Worst Case,True,24,34
47,96372106,5,10637342,1,60,0.009906291961669922,0.00103759765625,29,36,7,34,29,36,7,34,0.0,uniform,Min Worst Case,True,28,40
48,96372106,5,10637343,1,60,0.0024166107177734375,0.0009448528289794922,27,36,9,33,27,36,9,33,0.0,uniform,Min Worst Case,True,27,39
49,96372106,5,10637344,1,60,0.005112171173095703,0.0010974407196044922,29,41,12,38,29,41,12,38,0.0,uniform,Min Worst Case,True,28,38
50,96372106,5,10637345,1,60,0.027017831802368164,0.001409292221069336,44,58,14,52,44,58,14,52,0.0,uniform,Min Worst Case,True,43,63
